wagnérien	wagnérienne
wagnérien	wagnériennes
wagon-lit	wagons-lits
wagon	wagons
wagonnet	wagonnets
wagon-poste	wagons-poste
wagon-citerne	wagons-citernes
walkie-talkie	walkies-talkies
wagon-restaurant	wagons-restaurants
walkman	walkmans
wallaby	wallabies
wallingant	wallingants
wallingant	wallingantes
wallingant	wallingante
wallisien	wallisienne
wallisien	wallisiennes
wallisien	wallisiens
wallon	wallonne
wallon	wallonnes
wallon	wallons
warrant	warrants
wassingue	wassingues
warning	warnings
water-ballast	water-ballasts
wapiti	wapitis
water-closet	water-closets
wateringue	wateringues
water	waters
water-polo	water-polos
wattman	wattmans
week-end	week end
week-end	week-ends
watt	watts
weimarien	weimarienne
western	westerns
wattman	wattmen
westphalien	westphaliennes
welter	welters
whisky	whiskies
whig	whigs
wharf	wharfs
whisky-soda	whisky-sodas
white-spirit	white-spirits
wigwam	wigwams
willaya	willayas
whist	whists
winchester	winchesters
wisigoth	wisigothe
wisigoth	wisigoths
wisigothique	wisigothiques
wolfram	wolframs
wishbone	wishbones
wurtembergeois	wurtembergeoise
whisky	whiskys
woofer	woofers
